11111111111111111
1CCCC1CCCCC1CCCC1
1C1CC1C1C1C1C11C1
1CPCC1C1C1C1C11C1
1C1CC1CCC1C1CCCC1
1C1CC111CCC1C11C1
1C1CCC1111CCC11C1
1C111CCCCCCCCC1C1
1CCC1C1111111C1C1
1C1CCC111CCCCC1C1
1C111C111C11111C1
1CCCCCCCCCCCCCEC1
11111111111111111