111111
1CPCC1
1C00C1
1ECCC1
111111
