111111111111111111111111111111111111111111
100000000CCCCCCCC0000000000000000000000001
100000000CCCCCCCC0000000000000000000000001
100000000CCCCCCCC0000000000000000000000001
100P00000CCCCCCCC0000000000000000000000001
100000000CCCCCCCC0000000000000000000000001
100000000CCCCCCCC0000000000000000000000001
100000000CCCCCCCC0000000000000000000000001
100000000CCCCCCCC0000000000000000000000001
100000000CCCCCCCC0000000000000000000000001
100000000CCCCCCCC0000000000000000000000001
100000000CCCCCCCC0000000000000000000000001
100000000CCCCCCCC0000000000000000000000001
100000000CCCCCCCC0000000000000000000000001
100000000CCCCCCCC0000000000000000000000001
100000000CCCCCCCC0000000000000000000000001
100000000CCCCCCCC0000000000000000000000001
100000000CCCCCCCC0000000000000000000000001
100000000CCCCCCCC0000000000000000000000001
100000000CCCCCCCC0000000000000000000000001
100000000CCCCCCCC00000000000000000000000E1
100000000CCCCCCCC0000000000000000000000001
100000000CCCCCCCC0000000000000000000000001
100000000CCCCCCCC0000000000000000000000001
100000000CCCCCCCC0000000000000000000000001
100000000CCCCCCCC0000000000000000000000001
100000000CCCCCCCC0000000000000000000000001
100000000CCCCCCCC0000000000000000000000001
100000000CCCCCCCC0000000000000000000000001
111111111111111111111111111111111111111111