111111111
1P00001C1
100C00111
100C000E1
111111111