111111111
1P00001E1
100C00111
100C00001
111111111