11111111
1PCE0001
1BCCCCC1
11111111