11111111
100011111111
11PEC111
11111111111