11111111
1000011111111
11PEC111
11111111111