111111
1PCCC1
1C11C1
1CCCE1
111111