111111
1PCCC1
1C11C1
1CCCC1
111111