111111
1CPCC1
1CC001
100001
1000E1
111111